"filename", "language", "PHP", "JSON", "Markdown", "YAML", "comment", "blank", "total"
"c:\laragon\www\equizzy\vendor\autoload.php", "PHP", -20, 0, 0, 0, -1, -5, -26
"c:\laragon\www\equizzy\vendor\composer\ClassLoader.php", "PHP", -276, 0, 0, 0, -240, -57, -573
"c:\laragon\www\equizzy\vendor\composer\InstalledVersions.php", "PHP", -174, 0, 0, 0, -131, -48, -353
"c:\laragon\www\equizzy\vendor\composer\autoload_classmap.php", "PHP", -11, 0, 0, 0, -1, -4, -16
"c:\laragon\www\equizzy\vendor\composer\autoload_files.php", "PHP", -10, 0, 0, 0, -1, -4, -15
"c:\laragon\www\equizzy\vendor\composer\autoload_namespaces.php", "PHP", -5, 0, 0, 0, -1, -4, -10
"c:\laragon\www\equizzy\vendor\composer\autoload_psr4.php", "PHP", -18, 0, 0, 0, -1, -4, -23
"c:\laragon\www\equizzy\vendor\composer\autoload_real.php", "PHP", -36, 0, 0, 0, -9, -13, -58
"c:\laragon\www\equizzy\vendor\composer\autoload_static.php", "PHP", -118, 0, 0, 0, -1, -9, -128
"c:\laragon\www\equizzy\vendor\composer\installed.json", "JSON", 0, -782, 0, 0, 0, -1, -783
"c:\laragon\www\equizzy\vendor\composer\installed.php", "PHP", -119, 0, 0, 0, 0, -1, -120
"c:\laragon\www\equizzy\vendor\composer\platform_check.php", "PHP", -21, 0, 0, 0, -1, -5, -27
"c:\laragon\www\equizzy\vendor\graham-campbell\result-type\composer.json", "JSON", 0, -33, 0, 0, 0, -1, -34
"c:\laragon\www\equizzy\vendor\graham-campbell\result-type\src\Error.php", "PHP", -37, 0, 0, 0, -71, -13, -121
"c:\laragon\www\equizzy\vendor\graham-campbell\result-type\src\Result.php", "PHP", -11, 0, 0, 0, -50, -9, -70
"c:\laragon\www\equizzy\vendor\graham-campbell\result-type\src\Success.php", "PHP", -37, 0, 0, 0, -70, -13, -120
"c:\laragon\www\equizzy\vendor\guzzlehttp\psr7\.github\FUNDING.yml", "YAML", 0, 0, 0, -2, 0, -1, -3
"c:\laragon\www\equizzy\vendor\guzzlehttp\psr7\.github\stale.yml", "YAML", 0, 0, 0, -11, -3, -1, -15
"c:\laragon\www\equizzy\vendor\guzzlehttp\psr7\.github\workflows\ci.yml", "YAML", 0, 0, 0, -27, 0, -8, -35
"c:\laragon\www\equizzy\vendor\guzzlehttp\psr7\.github\workflows\integration.yml", "YAML", 0, 0, 0, -29, 0, -9, -38
"c:\laragon\www\equizzy\vendor\guzzlehttp\psr7\.github\workflows\static.yml", "YAML", 0, 0, 0, -22, 0, -8, -30
"c:\laragon\www\equizzy\vendor\guzzlehttp\psr7\CHANGELOG.md", "Markdown", 0, 0, -192, 0, 0, -127, -319
"c:\laragon\www\equizzy\vendor\guzzlehttp\psr7\README.md", "Markdown", 0, 0, -520, 0, 0, -325, -845
"c:\laragon\www\equizzy\vendor\guzzlehttp\psr7\composer.json", "JSON", 0, -76, 0, 0, 0, -1, -77
"c:\laragon\www\equizzy\vendor\guzzlehttp\psr7\src\AppendStream.php", "PHP", -152, 0, 0, 0, -54, -41, -247
"c:\laragon\www\equizzy\vendor\guzzlehttp\psr7\src\BufferStream.php", "PHP", -90, 0, 0, 0, -26, -27, -143
"c:\laragon\www\equizzy\vendor\guzzlehttp\psr7\src\CachingStream.php", "PHP", -93, 0, 0, 0, -30, -25, -148
"c:\laragon\www\equizzy\vendor\guzzlehttp\psr7\src\DroppingStream.php", "PHP", -24, 0, 0, 0, -12, -10, -46
"c:\laragon\www\equizzy\vendor\guzzlehttp\psr7\src\FnStream.php", "PHP", -99, 0, 0, 0, -38, -27, -164
"c:\laragon\www\equizzy\vendor\guzzlehttp\psr7\src\Header.php", "PHP", -46, 0, 0, 0, -18, -8, -72
"c:\laragon\www\equizzy\vendor\guzzlehttp\psr7\src\InflateStream.php", "PHP", -27, 0, 0, 0, -22, -8, -57
"c:\laragon\www\equizzy\vendor\guzzlehttp\psr7\src\LazyOpenStream.php", "PHP", -18, 0, 0, 0, -17, -8, -43
"c:\laragon\www\equizzy\vendor\guzzlehttp\psr7\src\LimitStream.php", "PHP", -88, 0, 0, 0, -47, -23, -158
"c:\laragon\www\equizzy\vendor\guzzlehttp\psr7\src\Message.php", "PHP", -144, 0, 0, 0, -70, -39, -253
"c:\laragon\www\equizzy\vendor\guzzlehttp\psr7\src\MessageTrait.php", "PHP", -168, 0, 0, 0, -60, -43, -271
"c:\laragon\www\equizzy\vendor\guzzlehttp\psr7\src\MimeType.php", "PHP", -119, 0, 0, 0, -16, -6, -141
"c:\laragon\www\equizzy\vendor\guzzlehttp\psr7\src\MultipartStream.php", "PHP", -98, 0, 0, 0, -36, -25, -159
"c:\laragon\www\equizzy\vendor\guzzlehttp\psr7\src\NoSeekStream.php", "PHP", -15, 0, 0, 0, -5, -6, -26
"c:\laragon\www\equizzy\vendor\guzzlehttp\psr7\src\PumpStream.php", "PHP", -114, 0, 0, 0, -27, -30, -171
"c:\laragon\www\equizzy\vendor\guzzlehttp\psr7\src\Query.php", "PHP", -76, 0, 0, 0, -27, -11, -114
"c:\laragon\www\equizzy\vendor\guzzlehttp\psr7\src\Request.php", "PHP", -110, 0, 0, 0, -15, -28, -153
"c:\laragon\www\equizzy\vendor\guzzlehttp\psr7\src\Response.php", "PHP", -125, 0, 0, 0, -13, -18, -156
"c:\laragon\www\equizzy\vendor\guzzlehttp\psr7\src\Rfc7230.php", "PHP", -7, 0, 0, 0, -10, -3, -20
"c:\laragon\www\equizzy\vendor\guzzlehttp\psr7\src\ServerRequest.php", "PHP", -203, 0, 0, 0, -123, -54, -380
"c:\laragon\www\equizzy\vendor\guzzlehttp\psr7\src\Stream.php", "PHP", -192, 0, 0, 0, -32, -47, -271
"c:\laragon\www\equizzy\vendor\guzzlehttp\psr7\src\StreamDecoratorTrait.php", "PHP", -96, 0, 0, 0, -33, -24, -153
"c:\laragon\www\equizzy\vendor\guzzlehttp\psr7\src\StreamWrapper.php", "PHP", -113, 0, 0, 0, -27, -26, -166
"c:\laragon\www\equizzy\vendor\guzzlehttp\psr7\src\UploadedFile.php", "PHP", -170, 0, 0, 0, -118, -41, -329
"c:\laragon\www\equizzy\vendor\guzzlehttp\psr7\src\Uri.php", "PHP", -419, 0, 0, 0, -280, -112, -811
"c:\laragon\www\equizzy\vendor\guzzlehttp\psr7\src\UriComparator.php", "PHP", -30, 0, 0, 0, -15, -11, -56
"c:\laragon\www\equizzy\vendor\guzzlehttp\psr7\src\UriNormalizer.php", "PHP", -80, 0, 0, 0, -111, -29, -220
"c:\laragon\www\equizzy\vendor\guzzlehttp\psr7\src\UriResolver.php", "PHP", -128, 0, 0, 0, -70, -25, -223
"c:\laragon\www\equizzy\vendor\guzzlehttp\psr7\src\Utils.php", "PHP", -240, 0, 0, 0, -144, -45, -429
"c:\laragon\www\equizzy\vendor\guzzlehttp\psr7\src\functions.php", "PHP", -94, 0, 0, 0, -304, -25, -423
"c:\laragon\www\equizzy\vendor\guzzlehttp\psr7\src\functions_include.php", "PHP", -4, 0, 0, 0, -1, -2, -7
"c:\laragon\www\equizzy\vendor\intervention\image\composer.json", "JSON", 0, -47, 0, 0, 0, -1, -48
"c:\laragon\www\equizzy\vendor\intervention\image\provides.json", "JSON", 0, -11, 0, 0, 0, -1, -12
"c:\laragon\www\equizzy\vendor\intervention\image\src\Intervention\Image\AbstractColor.php", "PHP", -99, 0, 0, 0, -95, -36, -230
"c:\laragon\www\equizzy\vendor\intervention\image\src\Intervention\Image\AbstractDecoder.php", "PHP", -176, 0, 0, 0, -125, -59, -360
"c:\laragon\www\equizzy\vendor\intervention\image\src\Intervention\Image\AbstractDriver.php", "PHP", -51, 0, 0, 0, -67, -19, -137
"c:\laragon\www\equizzy\vendor\intervention\image\src\Intervention\Image\AbstractEncoder.php", "PHP", -124, 0, 0, 0, -83, -38, -245
"c:\laragon\www\equizzy\vendor\intervention\image\src\Intervention\Image\AbstractFont.php", "PHP", -92, 0, 0, 0, -140, -36, -268
"c:\laragon\www\equizzy\vendor\intervention\image\src\Intervention\Image\AbstractShape.php", "PHP", -22, 0, 0, 0, -41, -9, -72
"c:\laragon\www\equizzy\vendor\intervention\image\src\Intervention\Image\Commands\AbstractCommand.php", "PHP", -29, 0, 0, 0, -42, -11, -82
"c:\laragon\www\equizzy\vendor\intervention\image\src\Intervention\Image\Commands\Argument.php", "PHP", -135, 0, 0, 0, -58, -33, -226
"c:\laragon\www\equizzy\vendor\intervention\image\src\Intervention\Image\Commands\ChecksumCommand.php", "PHP", -17, 0, 0, 0, -6, -7, -30
"c:\laragon\www\equizzy\vendor\intervention\image\src\Intervention\Image\Commands\CircleCommand.php", "PHP", -21, 0, 0, 0, -6, -9, -36
"c:\laragon\www\equizzy\vendor\intervention\image\src\Intervention\Image\Commands\EllipseCommand.php", "PHP", -22, 0, 0, 0, -6, -9, -37
"c:\laragon\www\equizzy\vendor\intervention\image\src\Intervention\Image\Commands\ExifCommand.php", "PHP", -33, 0, 0, 0, -10, -9, -52
"c:\laragon\www\equizzy\vendor\intervention\image\src\Intervention\Image\Commands\IptcCommand.php", "PHP", -49, 0, 0, 0, -6, -12, -67
"c:\laragon\www\equizzy\vendor\intervention\image\src\Intervention\Image\Commands\LineCommand.php", "PHP", -22, 0, 0, 0, -6, -9, -37
"c:\laragon\www\equizzy\vendor\intervention\image\src\Intervention\Image\Commands\OrientateCommand.php", "PHP", -32, 0, 0, 0, -6, -11, -49
"c:\laragon\www\equizzy\vendor\intervention\image\src\Intervention\Image\Commands\PolygonCommand.php", "PHP", -31, 0, 0, 0, -7, -12, -50
"c:\laragon\www\equizzy\vendor\intervention\image\src\Intervention\Image\Commands\PsrResponseCommand.php", "PHP", -25, 0, 0, 0, -13, -7, -45
"c:\laragon\www\equizzy\vendor\intervention\image\src\Intervention\Image\Commands\RectangleCommand.php", "PHP", -22, 0, 0, 0, -6, -9, -37
"c:\laragon\www\equizzy\vendor\intervention\image\src\Intervention\Image\Commands\ResponseCommand.php", "PHP", -14, 0, 0, 0, -6, -7, -27
"c:\laragon\www\equizzy\vendor\intervention\image\src\Intervention\Image\Commands\StreamCommand.php", "PHP", -14, 0, 0, 0, -7, -4, -25
"c:\laragon\www\equizzy\vendor\intervention\image\src\Intervention\Image\Commands\TextCommand.php", "PHP", -21, 0, 0, 0, -5, -9, -35
"c:\laragon\www\equizzy\vendor\intervention\image\src\Intervention\Image\Constraint.php", "PHP", -33, 0, 0, 0, -48, -12, -93
"c:\laragon\www\equizzy\vendor\intervention\image\src\Intervention\Image\Exception\ImageException.php", "PHP", -6, 0, 0, 0, 0, -3, -9
"c:\laragon\www\equizzy\vendor\intervention\image\src\Intervention\Image\Exception\InvalidArgumentException.php", "PHP", -6, 0, 0, 0, 0, -3, -9
"c:\laragon\www\equizzy\vendor\intervention\image\src\Intervention\Image\Exception\MissingDependencyException.php", "PHP", -6, 0, 0, 0, 0, -3, -9
"c:\laragon\www\equizzy\vendor\intervention\image\src\Intervention\Image\Exception\NotFoundException.php", "PHP", -6, 0, 0, 0, 0, -3, -9
"c:\laragon\www\equizzy\vendor\intervention\image\src\Intervention\Image\Exception\NotReadableException.php", "PHP", -6, 0, 0, 0, 0, -3, -9
"c:\laragon\www\equizzy\vendor\intervention\image\src\Intervention\Image\Exception\NotSupportedException.php", "PHP", -6, 0, 0, 0, 0, -3, -9
"c:\laragon\www\equizzy\vendor\intervention\image\src\Intervention\Image\Exception\NotWritableException.php", "PHP", -6, 0, 0, 0, 0, -3, -9
"c:\laragon\www\equizzy\vendor\intervention\image\src\Intervention\Image\Exception\RuntimeException.php", "PHP", -6, 0, 0, 0, 0, -3, -9
"c:\laragon\www\equizzy\vendor\intervention\image\src\Intervention\Image\Facades\Image.php", "PHP", -10, 0, 0, 0, -6, -4, -20
"c:\laragon\www\equizzy\vendor\intervention\image\src\Intervention\Image\File.php", "PHP", -37, 0, 0, 0, -40, -16, -93
"c:\laragon\www\equizzy\vendor\intervention\image\src\Intervention\Image\Filters\DemoFilter.php", "PHP", -18, 0, 0, 0, -19, -8, -45
"c:\laragon\www\equizzy\vendor\intervention\image\src\Intervention\Image\Filters\FilterInterface.php", "PHP", -7, 0, 0, 0, -6, -4, -17
"c:\laragon\www\equizzy\vendor\intervention\image\src\Intervention\Image\Gd\Color.php", "PHP", -102, 0, 0, 0, -97, -29, -228
"c:\laragon\www\equizzy\vendor\intervention\image\src\Intervention\Image\Gd\Commands\BackupCommand.php", "PHP", -13, 0, 0, 0, -7, -6, -26
"c:\laragon\www\equizzy\vendor\intervention\image\src\Intervention\Image\Gd\Commands\BlurCommand.php", "PHP", -14, 0, 0, 0, -6, -6, -26
"c:\laragon\www\equizzy\vendor\intervention\image\src\Intervention\Image\Gd\Commands\BrightnessCommand.php", "PHP", -11, 0, 0, 0, -6, -5, -22
"c:\laragon\www\equizzy\vendor\intervention\image\src\Intervention\Image\Gd\Commands\ColorizeCommand.php", "PHP", -16, 0, 0, 0, -8, -6, -30
"c:\laragon\www\equizzy\vendor\intervention\image\src\Intervention\Image\Gd\Commands\ContrastCommand.php", "PHP", -11, 0, 0, 0, -6, -5, -22
"c:\laragon\www\equizzy\vendor\intervention\image\src\Intervention\Image\Gd\Commands\CropCommand.php", "PHP", -25, 0, 0, 0, -8, -8, -41
"c:\laragon\www\equizzy\vendor\intervention\image\src\Intervention\Image\Gd\Commands\DestroyCommand.php", "PHP", -14, 0, 0, 0, -8, -6, -28
"c:\laragon\www\equizzy\vendor\intervention\image\src\Intervention\Image\Gd\Commands\FillCommand.php", "PHP", -39, 0, 0, 0, -13, -18, -70
"c:\laragon\www\equizzy\vendor\intervention\image\src\Intervention\Image\Gd\Commands\FitCommand.php", "PHP", -18, 0, 0, 0, -8, -7, -33
"c:\laragon\www\equizzy\vendor\intervention\image\src\Intervention\Image\Gd\Commands\FlipCommand.php", "PHP", -25, 0, 0, 0, -6, -7, -38
"c:\laragon\www\equizzy\vendor\intervention\image\src\Intervention\Image\Gd\Commands\GammaCommand.php", "PHP", -11, 0, 0, 0, -6, -5, -22
"c:\laragon\www\equizzy\vendor\intervention\image\src\Intervention\Image\Gd\Commands\GetSizeCommand.php", "PHP", -15, 0, 0, 0, -6, -5, -26
"c:\laragon\www\equizzy\vendor\intervention\image\src\Intervention\Image\Gd\Commands\GreyscaleCommand.php", "PHP", -10, 0, 0, 0, -6, -4, -20
"c:\laragon\www\equizzy\vendor\intervention\image\src\Intervention\Image\Gd\Commands\HeightenCommand.php", "PHP", -18, 0, 0, 0, -6, -5, -29
"c:\laragon\www\equizzy\vendor\intervention\image\src\Intervention\Image\Gd\Commands\InsertCommand.php", "PHP", -19, 0, 0, 0, -9, -7, -35
"c:\laragon\www\equizzy\vendor\intervention\image\src\Intervention\Image\Gd\Commands\InterlaceCommand.php", "PHP", -12, 0, 0, 0, -6, -6, -24
"c:\laragon\www\equizzy\vendor\intervention\image\src\Intervention\Image\Gd\Commands\InvertCommand.php", "PHP", -10, 0, 0, 0, -6, -4, -20
"c:\laragon\www\equizzy\vendor\intervention\image\src\Intervention\Image\Gd\Commands\LimitColorsCommand.php", "PHP", -26, 0, 0, 0, -14, -14, -54
"c:\laragon\www\equizzy\vendor\intervention\image\src\Intervention\Image\Gd\Commands\MaskCommand.php", "PHP", -44, 0, 0, 0, -17, -23, -84
"c:\laragon\www\equizzy\vendor\intervention\image\src\Intervention\Image\Gd\Commands\OpacityCommand.php", "PHP", -15, 0, 0, 0, -9, -8, -32
"c:\laragon\www\equizzy\vendor\intervention\image\src\Intervention\Image\Gd\Commands\PickColorCommand.php", "PHP", -21, 0, 0, 0, -8, -9, -38
"c:\laragon\www\equizzy\vendor\intervention\image\src\Intervention\Image\Gd\Commands\PixelCommand.php", "PHP", -15, 0, 0, 0, -6, -5, -26
"c:\laragon\www\equizzy\vendor\intervention\image\src\Intervention\Image\Gd\Commands\PixelateCommand.php", "PHP", -11, 0, 0, 0, -6, -5, -22
"c:\laragon\www\equizzy\vendor\intervention\image\src\Intervention\Image\Gd\Commands\ResetCommand.php", "PHP", -20, 0, 0, 0, -9, -10, -39
"c:\laragon\www\equizzy\vendor\intervention\image\src\Intervention\Image\Gd\Commands\ResizeCanvasCommand.php", "PHP", -53, 0, 0, 0, -15, -16, -84
"c:\laragon\www\equizzy\vendor\intervention\image\src\Intervention\Image\Gd\Commands\ResizeCommand.php", "PHP", -44, 0, 0, 0, -27, -14, -85
"c:\laragon\www\equizzy\vendor\intervention\image\src\Intervention\Image\Gd\Commands\RotateCommand.php", "PHP", -16, 0, 0, 0, -8, -7, -31
"c:\laragon\www\equizzy\vendor\intervention\image\src\Intervention\Image\Gd\Commands\SharpenCommand.php", "PHP", -20, 0, 0, 0, -8, -7, -35
"c:\laragon\www\equizzy\vendor\intervention\image\src\Intervention\Image\Gd\Commands\TrimCommand.php", "PHP", -117, 0, 0, 0, -16, -44, -177
"c:\laragon\www\equizzy\vendor\intervention\image\src\Intervention\Image\Gd\Commands\WidenCommand.php", "PHP", -18, 0, 0, 0, -6, -5, -29
"c:\laragon\www\equizzy\vendor\intervention\image\src\Intervention\Image\Gd\Decoder.php", "PHP", -94, 0, 0, 0, -36, -26, -156
"c:\laragon\www\equizzy\vendor\intervention\image\src\Intervention\Image\Gd\Driver.php", "PHP", -45, 0, 0, 0, -32, -13, -90
"c:\laragon\www\equizzy\vendor\intervention\image\src\Intervention\Image\Gd\Encoder.php", "PHP", -74, 0, 0, 0, -35, -16, -125
"c:\laragon\www\equizzy\vendor\intervention\image\src\Intervention\Image\Gd\Font.php", "PHP", -160, 0, 0, 0, -47, -50, -257
"c:\laragon\www\equizzy\vendor\intervention\image\src\Intervention\Image\Gd\Shapes\CircleShape.php", "PHP", -17, 0, 0, 0, -18, -6, -41
"c:\laragon\www\equizzy\vendor\intervention\image\src\Intervention\Image\Gd\Shapes\EllipseShape.php", "PHP", -28, 0, 0, 0, -27, -11, -66
"c:\laragon\www\equizzy\vendor\intervention\image\src\Intervention\Image\Gd\Shapes\LineShape.php", "PHP", -33, 0, 0, 0, -46, -12, -91
"c:\laragon\www\equizzy\vendor\intervention\image\src\Intervention\Image\Gd\Shapes\PolygonShape.php", "PHP", -24, 0, 0, 0, -18, -8, -50
"c:\laragon\www\equizzy\vendor\intervention\image\src\Intervention\Image\Gd\Shapes\RectangleShape.php", "PHP", -30, 0, 0, 0, -36, -11, -77
"c:\laragon\www\equizzy\vendor\intervention\image\src\Intervention\Image\Image.php", "PHP", -135, 0, 0, 0, -193, -43, -371
"c:\laragon\www\equizzy\vendor\intervention\image\src\Intervention\Image\ImageManager.php", "PHP", -69, 0, 0, 0, -55, -19, -143
"c:\laragon\www\equizzy\vendor\intervention\image\src\Intervention\Image\ImageManagerStatic.php", "PHP", -31, 0, 0, 0, -48, -10, -89
"c:\laragon\www\equizzy\vendor\intervention\image\src\Intervention\Image\ImageServiceProvider.php", "PHP", -40, 0, 0, 0, -36, -12, -88
"c:\laragon\www\equizzy\vendor\intervention\image\src\Intervention\Image\ImageServiceProviderLaravel4.php", "PHP", -62, 0, 0, 0, -24, -27, -113
"c:\laragon\www\equizzy\vendor\intervention\image\src\Intervention\Image\ImageServiceProviderLaravel5.php", "PHP", -48, 0, 0, 0, -26, -16, -90
"c:\laragon\www\equizzy\vendor\intervention\image\src\Intervention\Image\ImageServiceProviderLeague.php", "PHP", -20, 0, 0, 0, -16, -7, -43
"c:\laragon\www\equizzy\vendor\intervention\image\src\Intervention\Image\ImageServiceProviderLumen.php", "PHP", -19, 0, 0, 0, -8, -8, -35
"c:\laragon\www\equizzy\vendor\intervention\image\src\Intervention\Image\Imagick\Color.php", "PHP", -129, 0, 0, 0, -118, -33, -280
"c:\laragon\www\equizzy\vendor\intervention\image\src\Intervention\Image\Imagick\Commands\BackupCommand.php", "PHP", -13, 0, 0, 0, -7, -6, -26
"c:\laragon\www\equizzy\vendor\intervention\image\src\Intervention\Image\Imagick\Commands\BlurCommand.php", "PHP", -11, 0, 0, 0, -6, -5, -22
"c:\laragon\www\equizzy\vendor\intervention\image\src\Intervention\Image\Imagick\Commands\BrightnessCommand.php", "PHP", -11, 0, 0, 0, -6, -5, -22
"c:\laragon\www\equizzy\vendor\intervention\image\src\Intervention\Image\Imagick\Commands\ColorizeCommand.php", "PHP", -28, 0, 0, 0, -8, -9, -45
"c:\laragon\www\equizzy\vendor\intervention\image\src\Intervention\Image\Imagick\Commands\ContrastCommand.php", "PHP", -11, 0, 0, 0, -6, -5, -22
"c:\laragon\www\equizzy\vendor\intervention\image\src\Intervention\Image\Imagick\Commands\CropCommand.php", "PHP", -29, 0, 0, 0, -8, -9, -46
"c:\laragon\www\equizzy\vendor\intervention\image\src\Intervention\Image\Imagick\Commands\DestroyCommand.php", "PHP", -14, 0, 0, 0, -8, -6, -28
"c:\laragon\www\equizzy\vendor\intervention\image\src\Intervention\Image\Imagick\Commands\ExifCommand.php", "PHP", -38, 0, 0, 0, -14, -12, -64
"c:\laragon\www\equizzy\vendor\intervention\image\src\Intervention\Image\Imagick\Commands\FillCommand.php", "PHP", -52, 0, 0, 0, -25, -29, -106
"c:\laragon\www\equizzy\vendor\intervention\image\src\Intervention\Image\Imagick\Commands\FitCommand.php", "PHP", -26, 0, 0, 0, -9, -8, -43
"c:\laragon\www\equizzy\vendor\intervention\image\src\Intervention\Image\Imagick\Commands\FlipCommand.php", "PHP", -15, 0, 0, 0, -8, -5, -28
"c:\laragon\www\equizzy\vendor\intervention\image\src\Intervention\Image\Imagick\Commands\GammaCommand.php", "PHP", -11, 0, 0, 0, -6, -5, -22
"c:\laragon\www\equizzy\vendor\intervention\image\src\Intervention\Image\Imagick\Commands\GetSizeCommand.php", "PHP", -16, 0, 0, 0, -7, -6, -29
"c:\laragon\www\equizzy\vendor\intervention\image\src\Intervention\Image\Imagick\Commands\GreyscaleCommand.php", "PHP", -10, 0, 0, 0, -6, -4, -20
"c:\laragon\www\equizzy\vendor\intervention\image\src\Intervention\Image\Imagick\Commands\HeightenCommand.php", "PHP", -18, 0, 0, 0, -6, -5, -29
"c:\laragon\www\equizzy\vendor\intervention\image\src\Intervention\Image\Imagick\Commands\InsertCommand.php", "PHP", -18, 0, 0, 0, -9, -7, -34
"c:\laragon\www\equizzy\vendor\intervention\image\src\Intervention\Image\Imagick\Commands\InterlaceCommand.php", "PHP", -17, 0, 0, 0, -6, -7, -30
"c:\laragon\www\equizzy\vendor\intervention\image\src\Intervention\Image\Imagick\Commands\InvertCommand.php", "PHP", -10, 0, 0, 0, -6, -4, -20
"c:\laragon\www\equizzy\vendor\intervention\image\src\Intervention\Image\Imagick\Commands\LimitColorsCommand.php", "PHP", -30, 0, 0, 0, -13, -17, -60
"c:\laragon\www\equizzy\vendor\intervention\image\src\Intervention\Image\Imagick\Commands\MaskCommand.php", "PHP", -30, 0, 0, 0, -15, -16, -61
"c:\laragon\www\equizzy\vendor\intervention\image\src\Intervention\Image\Imagick\Commands\OpacityCommand.php", "PHP", -12, 0, 0, 0, -6, -6, -24
"c:\laragon\www\equizzy\vendor\intervention\image\src\Intervention\Image\Imagick\Commands\PickColorCommand.php", "PHP", -16, 0, 0, 0, -8, -7, -31
"c:\laragon\www\equizzy\vendor\intervention\image\src\Intervention\Image\Imagick\Commands\PixelCommand.php", "PHP", -18, 0, 0, 0, -8, -6, -32
"c:\laragon\www\equizzy\vendor\intervention\image\src\Intervention\Image\Imagick\Commands\PixelateCommand.php", "PHP", -15, 0, 0, 0, -6, -7, -28
"c:\laragon\www\equizzy\vendor\intervention\image\src\Intervention\Image\Imagick\Commands\ResetCommand.php", "PHP", -21, 0, 0, 0, -9, -11, -41
"c:\laragon\www\equizzy\vendor\intervention\image\src\Intervention\Image\Imagick\Commands\ResizeCanvasCommand.php", "PHP", -60, 0, 0, 0, -15, -17, -92
"c:\laragon\www\equizzy\vendor\intervention\image\src\Intervention\Image\Imagick\Commands\ResizeCommand.php", "PHP", -15, 0, 0, 0, -8, -7, -30
"c:\laragon\www\equizzy\vendor\intervention\image\src\Intervention\Image\Imagick\Commands\RotateCommand.php", "PHP", -16, 0, 0, 0, -8, -7, -31
"c:\laragon\www\equizzy\vendor\intervention\image\src\Intervention\Image\Imagick\Commands\SharpenCommand.php", "PHP", -11, 0, 0, 0, -6, -5, -22
"c:\laragon\www\equizzy\vendor\intervention\image\src\Intervention\Image\Imagick\Commands\TrimCommand.php", "PHP", -77, 0, 0, 0, -21, -24, -122
"c:\laragon\www\equizzy\vendor\intervention\image\src\Intervention\Image\Imagick\Commands\WidenCommand.php", "PHP", -18, 0, 0, 0, -6, -5, -29
"c:\laragon\www\equizzy\vendor\intervention\image\src\Intervention\Image\Imagick\Decoder.php", "PHP", -66, 0, 0, 0, -36, -23, -125
"c:\laragon\www\equizzy\vendor\intervention\image\src\Intervention\Image\Imagick\Driver.php", "PHP", -37, 0, 0, 0, -27, -11, -75
"c:\laragon\www\equizzy\vendor\intervention\image\src\Intervention\Image\Imagick\Encoder.php", "PHP", -110, 0, 0, 0, -35, -29, -174
"c:\laragon\www\equizzy\vendor\intervention\image\src\Intervention\Image\Imagick\Font.php", "PHP", -74, 0, 0, 0, -26, -22, -122
"c:\laragon\www\equizzy\vendor\intervention\image\src\Intervention\Image\Imagick\Shapes\CircleShape.php", "PHP", -17, 0, 0, 0, -18, -6, -41
"c:\laragon\www\equizzy\vendor\intervention\image\src\Intervention\Image\Imagick\Shapes\EllipseShape.php", "PHP", -29, 0, 0, 0, -26, -12, -67
"c:\laragon\www\equizzy\vendor\intervention\image\src\Intervention\Image\Imagick\Shapes\LineShape.php", "PHP", -35, 0, 0, 0, -46, -14, -95
"c:\laragon\www\equizzy\vendor\intervention\image\src\Intervention\Image\Imagick\Shapes\PolygonShape.php", "PHP", -42, 0, 0, 0, -26, -14, -82
"c:\laragon\www\equizzy\vendor\intervention\image\src\Intervention\Image\Imagick\Shapes\RectangleShape.php", "PHP", -33, 0, 0, 0, -38, -14, -85
"c:\laragon\www\equizzy\vendor\intervention\image\src\Intervention\Image\Point.php", "PHP", -25, 0, 0, 0, -32, -8, -65
"c:\laragon\www\equizzy\vendor\intervention\image\src\Intervention\Image\Response.php", "PHP", -37, 0, 0, 0, -27, -15, -79
"c:\laragon\www\equizzy\vendor\intervention\image\src\Intervention\Image\Size.php", "PHP", -208, 0, 0, 0, -110, -57, -375
"c:\laragon\www\equizzy\vendor\intervention\image\src\config\config.php", "PHP", -4, 0, 0, 0, -12, -5, -21
"c:\laragon\www\equizzy\vendor\phpoption\phpoption\composer.json", "JSON", 0, -52, 0, 0, 0, -1, -53
"c:\laragon\www\equizzy\vendor\phpoption\phpoption\src\PhpOption\LazyOption.php", "PHP", -105, 0, 0, 0, -41, -30, -176
"c:\laragon\www\equizzy\vendor\phpoption\phpoption\src\PhpOption\None.php", "PHP", -88, 0, 0, 0, -23, -26, -137
"c:\laragon\www\equizzy\vendor\phpoption\phpoption\src\PhpOption\Option.php", "PHP", -88, 0, 0, 0, -313, -34, -435
"c:\laragon\www\equizzy\vendor\phpoption\phpoption\src\PhpOption\Some.php", "PHP", -104, 0, 0, 0, -35, -31, -170
"c:\laragon\www\equizzy\vendor\psr\http-message\CHANGELOG.md", "Markdown", 0, 0, -24, 0, 0, -13, -37
"c:\laragon\www\equizzy\vendor\psr\http-message\README.md", "Markdown", 0, 0, -9, 0, 0, -4, -13
"c:\laragon\www\equizzy\vendor\psr\http-message\composer.json", "JSON", 0, -26, 0, 0, 0, -1, -27
"c:\laragon\www\equizzy\vendor\psr\http-message\src\MessageInterface.php", "PHP", -16, 0, 0, 0, -159, -13, -188
"c:\laragon\www\equizzy\vendor\psr\http-message\src\RequestInterface.php", "PHP", -11, 0, 0, 0, -111, -8, -130
"c:\laragon\www\equizzy\vendor\psr\http-message\src\ResponseInterface.php", "PHP", -8, 0, 0, 0, -56, -5, -69
"c:\laragon\www\equizzy\vendor\psr\http-message\src\ServerRequestInterface.php", "PHP", -18, 0, 0, 0, -229, -15, -262
"c:\laragon\www\equizzy\vendor\psr\http-message\src\StreamInterface.php", "PHP", -20, 0, 0, 0, -122, -17, -159
"c:\laragon\www\equizzy\vendor\psr\http-message\src\UploadedFileInterface.php", "PHP", -11, 0, 0, 0, -105, -8, -124
"c:\laragon\www\equizzy\vendor\psr\http-message\src\UriInterface.php", "PHP", -21, 0, 0, 0, -286, -17, -324
"c:\laragon\www\equizzy\vendor\ralouphie\getallheaders\README.md", "Markdown", 0, 0, -18, 0, 0, -10, -28
"c:\laragon\www\equizzy\vendor\ralouphie\getallheaders\composer.json", "JSON", 0, -26, 0, 0, 0, -1, -27
"c:\laragon\www\equizzy\vendor\ralouphie\getallheaders\src\getallheaders.php", "PHP", -34, 0, 0, 0, -5, -8, -47
"c:\laragon\www\equizzy\vendor\symfony\polyfill-ctype\Ctype.php", "PHP", -76, 0, 0, 0, -127, -30, -233
"c:\laragon\www\equizzy\vendor\symfony\polyfill-ctype\README.md", "Markdown", 0, 0, -8, 0, 0, -5, -13
"c:\laragon\www\equizzy\vendor\symfony\polyfill-ctype\bootstrap.php", "PHP", -38, 0, 0, 0, -8, -5, -51
"c:\laragon\www\equizzy\vendor\symfony\polyfill-ctype\bootstrap80.php", "PHP", -35, 0, 0, 0, -8, -4, -47
"c:\laragon\www\equizzy\vendor\symfony\polyfill-ctype\composer.json", "JSON", 0, -41, 0, 0, 0, -1, -42
"c:\laragon\www\equizzy\vendor\symfony\polyfill-mbstring\Mbstring.php", "PHP", -650, 0, 0, 0, -64, -160, -874
"c:\laragon\www\equizzy\vendor\symfony\polyfill-mbstring\README.md", "Markdown", 0, 0, -9, 0, 0, -5, -14
"c:\laragon\www\equizzy\vendor\symfony\polyfill-mbstring\Resources\unidata\lowerCase.php", "PHP", -1396, 0, 0, 0, 0, -2, -1398
"c:\laragon\www\equizzy\vendor\symfony\polyfill-mbstring\Resources\unidata\titleCaseRegexp.php", "PHP", -2, 0, 0, 0, -1, -3, -6
"c:\laragon\www\equizzy\vendor\symfony\polyfill-mbstring\Resources\unidata\upperCase.php", "PHP", -1488, 0, 0, 0, 0, -2, -1490
"c:\laragon\www\equizzy\vendor\symfony\polyfill-mbstring\bootstrap.php", "PHP", -131, 0, 0, 0, -8, -9, -148
"c:\laragon\www\equizzy\vendor\symfony\polyfill-mbstring\bootstrap80.php", "PHP", -128, 0, 0, 0, -8, -8, -144
"c:\laragon\www\equizzy\vendor\symfony\polyfill-mbstring\composer.json", "JSON", 0, -41, 0, 0, 0, -1, -42
"c:\laragon\www\equizzy\vendor\symfony\polyfill-php80\Php80.php", "PHP", -82, 0, 0, 0, -15, -19, -116
"c:\laragon\www\equizzy\vendor\symfony\polyfill-php80\PhpToken.php", "PHP", -57, 0, 0, 0, -31, -16, -104
"c:\laragon\www\equizzy\vendor\symfony\polyfill-php80\README.md", "Markdown", 0, 0, -20, 0, 0, -6, -26
"c:\laragon\www\equizzy\vendor\symfony\polyfill-php80\Resources\stubs\Attribute.php", "PHP", -18, 0, 0, 0, -1, -4, -23
"c:\laragon\www\equizzy\vendor\symfony\polyfill-php80\Resources\stubs\PhpToken.php", "PHP", -6, 0, 0, 0, 0, -2, -8
"c:\laragon\www\equizzy\vendor\symfony\polyfill-php80\Resources\stubs\Stringable.php", "PHP", -7, 0, 0, 0, -3, -2, -12
"c:\laragon\www\equizzy\vendor\symfony\polyfill-php80\Resources\stubs\UnhandledMatchError.php", "PHP", -6, 0, 0, 0, 0, -2, -8
"c:\laragon\www\equizzy\vendor\symfony\polyfill-php80\Resources\stubs\ValueError.php", "PHP", -6, 0, 0, 0, 0, -2, -8
"c:\laragon\www\equizzy\vendor\symfony\polyfill-php80\bootstrap.php", "PHP", -29, 0, 0, 0, -8, -6, -43
"c:\laragon\www\equizzy\vendor\symfony\polyfill-php80\composer.json", "JSON", 0, -40, 0, 0, 0, -1, -41
"c:\laragon\www\equizzy\vendor\vlucas\phpdotenv\composer.json", "JSON", 0, -53, 0, 0, 0, -1, -54
"c:\laragon\www\equizzy\vendor\vlucas\phpdotenv\src\Dotenv.php", "PHP", -104, 0, 0, 0, -132, -32, -268
"c:\laragon\www\equizzy\vendor\vlucas\phpdotenv\src\Exception\ExceptionInterface.php", "PHP", -7, 0, 0, 0, -1, -5, -13
"c:\laragon\www\equizzy\vendor\vlucas\phpdotenv\src\Exception\InvalidEncodingException.php", "PHP", -7, 0, 0, 0, -1, -5, -13
"c:\laragon\www\equizzy\vendor\vlucas\phpdotenv\src\Exception\InvalidFileException.php", "PHP", -7, 0, 0, 0, -1, -5, -13
"c:\laragon\www\equizzy\vendor\vlucas\phpdotenv\src\Exception\InvalidPathException.php", "PHP", -7, 0, 0, 0, -1, -5, -13
"c:\laragon\www\equizzy\vendor\vlucas\phpdotenv\src\Exception\ValidationException.php", "PHP", -7, 0, 0, 0, -1, -5, -13
"c:\laragon\www\equizzy\vendor\vlucas\phpdotenv\src\Loader\Loader.php", "PHP", -29, 0, 0, 0, -11, -8, -48
"c:\laragon\www\equizzy\vendor\vlucas\phpdotenv\src\Loader\LoaderInterface.php", "PHP", -8, 0, 0, 0, -8, -5, -21
"c:\laragon\www\equizzy\vendor\vlucas\phpdotenv\src\Loader\Resolver.php", "PHP", -32, 0, 0, 0, -27, -7, -66
"c:\laragon\www\equizzy\vendor\vlucas\phpdotenv\src\Parser\Entry.php", "PHP", -22, 0, 0, 0, -29, -9, -60
"c:\laragon\www\equizzy\vendor\vlucas\phpdotenv\src\Parser\EntryParser.php", "PHP", -166, 0, 0, 0, -103, -25, -294
"c:\laragon\www\equizzy\vendor\vlucas\phpdotenv\src\Parser\Lexer.php", "PHP", -27, 0, 0, 0, -21, -11, -59
"c:\laragon\www\equizzy\vendor\vlucas\phpdotenv\src\Parser\Lines.php", "PHP", -59, 0, 0, 0, -49, -18, -126
"c:\laragon\www\equizzy\vendor\vlucas\phpdotenv\src\Parser\Parser.php", "PHP", -30, 0, 0, 0, -17, -6, -53
"c:\laragon\www\equizzy\vendor\vlucas\phpdotenv\src\Parser\ParserInterface.php", "PHP", -7, 0, 0, 0, -9, -4, -20
"c:\laragon\www\equizzy\vendor\vlucas\phpdotenv\src\Parser\Value.php", "PHP", -35, 0, 0, 0, -41, -13, -89
"c:\laragon\www\equizzy\vendor\vlucas\phpdotenv\src\Repository\AdapterRepository.php", "PHP", -31, 0, 0, 0, -47, -11, -89
"c:\laragon\www\equizzy\vendor\vlucas\phpdotenv\src\Repository\Adapter\AdapterInterface.php", "PHP", -7, 0, 0, 0, -5, -4, -16
"c:\laragon\www\equizzy\vendor\vlucas\phpdotenv\src\Repository\Adapter\ApacheAdapter.php", "PHP", -37, 0, 0, 0, -42, -11, -90
"c:\laragon\www\equizzy\vendor\vlucas\phpdotenv\src\Repository\Adapter\ArrayAdapter.php", "PHP", -31, 0, 0, 0, -38, -12, -81
"c:\laragon\www\equizzy\vendor\vlucas\phpdotenv\src\Repository\Adapter\EnvConstAdapter.php", "PHP", -40, 0, 0, 0, -35, -13, -88
"c:\laragon\www\equizzy\vendor\vlucas\phpdotenv\src\Repository\Adapter\GuardedWriter.php", "PHP", -31, 0, 0, 0, -44, -11, -86
"c:\laragon\www\equizzy\vendor\vlucas\phpdotenv\src\Repository\Adapter\ImmutableWriter.php", "PHP", -41, 0, 0, 0, -54, -16, -111
"c:\laragon\www\equizzy\vendor\vlucas\phpdotenv\src\Repository\Adapter\MultiReader.php", "PHP", -22, 0, 0, 0, -19, -8, -49
"c:\laragon\www\equizzy\vendor\vlucas\phpdotenv\src\Repository\Adapter\MultiWriter.php", "PHP", -29, 0, 0, 0, -27, -9, -65
"c:\laragon\www\equizzy\vendor\vlucas\phpdotenv\src\Repository\Adapter\PutenvAdapter.php", "PHP", -39, 0, 0, 0, -40, -13, -92
"c:\laragon\www\equizzy\vendor\vlucas\phpdotenv\src\Repository\Adapter\ReaderInterface.php", "PHP", -7, 0, 0, 0, -7, -4, -18
"c:\laragon\www\equizzy\vendor\vlucas\phpdotenv\src\Repository\Adapter\ReplacingWriter.php", "PHP", -40, 0, 0, 0, -50, -15, -105
"c:\laragon\www\equizzy\vendor\vlucas\phpdotenv\src\Repository\Adapter\ServerConstAdapter.php", "PHP", -40, 0, 0, 0, -35, -13, -88
"c:\laragon\www\equizzy\vendor\vlucas\phpdotenv\src\Repository\Adapter\WriterInterface.php", "PHP", -8, 0, 0, 0, -15, -5, -28
"c:\laragon\www\equizzy\vendor\vlucas\phpdotenv\src\Repository\RepositoryBuilder.php", "PHP", -130, 0, 0, 0, -109, -34, -273
"c:\laragon\www\equizzy\vendor\vlucas\phpdotenv\src\Repository\RepositoryInterface.php", "PHP", -10, 0, 0, 0, -29, -7, -46
"c:\laragon\www\equizzy\vendor\vlucas\phpdotenv\src\Store\FileStore.php", "PHP", -30, 0, 0, 0, -31, -12, -73
"c:\laragon\www\equizzy\vendor\vlucas\phpdotenv\src\Store\File\Paths.php", "PHP", -19, 0, 0, 0, -19, -7, -45
"c:\laragon\www\equizzy\vendor\vlucas\phpdotenv\src\Store\File\Reader.php", "PHP", -35, 0, 0, 0, -37, -10, -82
"c:\laragon\www\equizzy\vendor\vlucas\phpdotenv\src\Store\StoreBuilder.php", "PHP", -51, 0, 0, 0, -74, -17, -142
"c:\laragon\www\equizzy\vendor\vlucas\phpdotenv\src\Store\StoreInterface.php", "PHP", -7, 0, 0, 0, -7, -4, -18
"c:\laragon\www\equizzy\vendor\vlucas\phpdotenv\src\Store\StringStore.php", "PHP", -15, 0, 0, 0, -17, -6, -38
"c:\laragon\www\equizzy\vendor\vlucas\phpdotenv\src\Util\Regex.php", "PHP", -43, 0, 0, 0, -56, -12, -111
"c:\laragon\www\equizzy\vendor\vlucas\phpdotenv\src\Util\Str.php", "PHP", -39, 0, 0, 0, -51, -9, -99
"c:\laragon\www\equizzy\vendor\vlucas\phpdotenv\src\Validator.php", "PHP", -102, 0, 0, 0, -88, -20, -210
"Total", "-", -14861, -1228, -800, -91, -8362, -4043, -29385